+-+-+-+-+-+-+-+-+-+-+-+-+-+-+-+-+-+-+-+-+-+-+-+-+-+
 #        |  #  | |       |       |         |     |
+#+-+-+-+ + + + + + +-+-+ + +-+-+ + + +-+-+ + +-+ +
|#####| | | | | |   |     |     | | | |   | |   | |
+-+-+#+ + + +-+ +-+-+ +-+-+-+-+ +-+ + + +-+ +-+ + +
|#####| | | |   |     |    #  |   | | |   |   | | |
+#+-+-+ + + + +-+ +-+-+ +-+ +-+-+ + + + + +-+ + + +
|## |    #|#|#  | |   |   |   | |   |   | |   | | |
+-+ + +-+#+#+ +-+ + + +-+ +-+ + +-+-+-+-+ + +-+-+ +
|###| | ##|#|#    | |     | | |   |       |   |   |
+#+-+-+#+-+#+-+-+-+ +-+-+-+ + +-+ + +-+-+ +-+ + +-+
|#|   |###|###|   | |   |  #| |   |     | |   | | |
+#+ + +-+#+-+#+-+ + + + + + + + +-+-+-+ + +-+-+ + +
|#| |   |#####|#  |   | | | | | |   |   |       | |
+#+-+-+ +-+-+#+#+-+-+-+ + +-+ + +-+ + +-+-+ +-+-+ +
|###| | |   |###|#  |   |#  | |#  |   |   | |   | |
+-+#+ + + + +-+#+#+ +-+-+ + + + + +-+-+ + + + + + +
|  ###|   |   |###| |   | | | | |   |   | | | | | |
+-+-+#+ +-+-+ +-+-+ + + + + + + +-+ + +-+-+ + + + +
|#####| |   |   | |#  |   |  #  |   |#  |     |   |
+#+-+-+ + + +-+ + +-+-+-+-+-+-+-+ +-+ + + +-+-+-+-+
|#|###| | | |   |         |     |     | |   |     |
+#+#+#+ + + + + + +-+-+-+ + +-+ +-+-+-+ +-+ + +-+ +
|###| | | |   | | |   | | | |   |   |   |   | |   |
+ +-+-+ + +-+-+-+ + + + + + + +-+ + + +-+ +-+-+ +-+
| |     |   |     | |     | | |   | | |   |   |   |
+ + +-+-+-+ + +-+-+ +-+-+-+-+ + +-+ + + +-+-+ + + +
|   |   |     |   |     |     | |   | | |   | | | |
+-+-+ + + +-+-+-+ +-+ + + +-+-+ + +-+-+ + + + + + +
|     | |   |   | |   |   |     |   |   | | | | | |
+ +-+-+ +-+ + + + + +-+-+-+ +-+-+-+ + + + + + + +-+
|     | |   | |   |         |       | | | |   |   |
+-+ + +-+ +-+ +-+-+-+ +-+ +-+ +-+-+-+ +-+ +-+-+-+ +
|   |       |   |     |   |   |   |     |         |
+ +-+-+-+-+ +-+ + +-+-+ +-+ + + + + + + + +-+-+-+-+
| |       | |   |     |   | | | |   | | | |   |   |
+ + + +-+ +-+ +-+-+-+ +-+ + +-+ +-+-+ + + + +-+ + +
| | |   | |   |     | |   |     |     |   |     | |
+ + +-+-+ + +-+ + +-+ +-+-+-+-+-+ + +-+-+-+ +-+-+-+
|   |     |     |   |   |     |   | |             |
+-+-+ +-+-+ +-+-+-+ + + + +-+ + +-+-+ +-+-+-+-+-+ +
|   | |   | |   | | | | | |   | |   |           | |
+ +-+ + + + + + + + +-+ + + +-+ + + +-+-+-+-+-+-+ +
| |   | | |   | | |       | | |   |       |   |   |
+ + +-+-+ +-+-+ + +-+-+ +-+ + +-+-+-+ +-+-+ + + +-+
|   |     | |   | | |     | |   |   |     | | | | |
+ +-+ +-+-+ + +-+ + + +-+-+ +-+ + + +-+-+ + + + + +
| |   |   | | | | | |   |       | | |   |   |   | |
+ + +-+ + + + + + + +-+ + +-+-+-+ + + + +-+-+-+-+ +
|   |   |       |       |         |   |            
+-+-+-+-+-+-+-+-+-+-+-+-+-+-+-+-+-+-+-+-+-+-+-+-+-+
