+-+-+-+-+-+-+-+-+-+-+-+-+-+-+-+-+-+-+-+-+-+-+-+-+-+
 #|#####    |         | |   |       |         |   |
+#+#+-+#+-+-+ +-+-+-+ + + + + +-+-+ + +-+-+-+ + +-+
|###| |#    |   |   |   | | |   |   |   |     |   |
+-+-+#+ +-+ +-+ + + +-+-+ + +-+ + +-+-+ + +-+-+ + +
|#   #  | | |   | |     | | |   |     | |     | | |
+#+-+-+-+ + + +-+ +-+-+-+ + + +-+-+-+ + +-+-+ + + +
|#|       |  #  |         |   |       | |   | | | |
+#+-+-+-+ +-+-+-+-+-+ +-+-+-+-+ +-+-+-+ + +-+ + + +
|###|   |           | |         |       |   | | | |
+-+#+ + +-+-+-+-+-+ + + +-+ +-+-+ +-+-+-+ + + + + +
|  #| |   |     |     |   | |   | | |   | | |   | |
+ +#+ + + + +-+ + + +-+-+-+ +-+ + + + + +-+ +-+-+ +
| | | | |   |   | | | |   |     | |   | |   |   | |
+ +-+ + +-+-+ +-+ + + + + +-+-+-+ + +-+ + +-+ + + +
|     |   |   |   |   | |   |   | |   |   |   |   |
+-+-+-+-+ + + + +-+ +-+ +-+ + + + +-+ +-+-+ +-+ +-+
|     |   | | | | |   | |     | | |   | |   |     |
+ +-+ + +-+ + + + +-+ + +-+ +-+ + + +-+ + + + + +-+
|   |   |   | | |     |   |   |   |       | | |   |
+-+ +-+-+ +-+-+ +-+-+-+-+ +-+ +-+-+-+-+-+-+-+ +-+ +
| |     |           |     | | |       |   |     | |
+ +-+-+ +-+-+-+ +-+-+ +-+-+ + + +-+-+ + +-+ +-+ +-+
|       |     | |     |   | | |     |         |   |
+ +-+-+-+ + + + +-+ +-+ +-+ + +-+-+ +-+-+-+-+ +-+ +
|   |     | | |     | |   |   |     |         |   |
+-+ + +-+-+ + +-+-+-+ +-+ +-+-+ +-+-+ +-+-+-+-+ +-+
|   | |     | |   |   | | |     |   | |       |   |
+ +-+ + +-+ + + + + + + + + +-+-+-+ + + + +-+ +-+ +
|     |   | |   | | |   | |       |   | |   | | | |
+-+-+-+-+ + +-+-+ + +-+ + +-+-+-+ +-+-+ +-+-+ + + +
|   |     | |   |   |   | |   |   |     |   | |   |
+ + + +-+-+ + +-+-+ + +-+ + + + +-+ +-+-+ + + + + +
| |   |   |   |   | |   | | | | |   |     |   | | |
+ +-+-+ + +-+-+ + +-+ +-+ +-+ + + +-+ +-+-+-+-+-+ +
| |   | |     | |     |       | | |     |   | |   |
+ +-+ + +-+ +-+ +-+-+-+ + +-+-+ + + +-+-+ + + + + +
|     |   |     |       |       | | |     | |   | |
+-+-+-+-+ +-+-+-+-+-+-+-+-+-+-+ + + + +-+-+ +-+-+ +
|   |     |           |   |   |   | |   |   |     |
+ + + +-+-+ +-+-+-+-+ + + + + +-+-+ + +-+ +-+ +-+-+
| |   |     |       | | | | |   |   | |   |   |   |
+ +-+-+ +-+-+ + +-+-+ + + + +-+ + +-+ + +-+ +-+-+ +
|       |   | |       | | | |     |   |     |   | |
+-+-+-+-+ + + +-+-+-+-+ + + +-+-+-+ +-+-+-+-+ + + +
| |       |   |     |   |   |     |     |     |   |
+ + +-+-+ +-+-+ +-+ + +-+-+-+ +-+ +-+-+ +-+ + +-+ +
| | | |   |   | | | |   |   |   |       |   |   | |
+ + + + +-+ +-+ + + +-+ + + +-+ +-+-+-+-+ +-+-+ + +
|   |   |       |       | |               |     |  
+-+-+-+-+-+-+-+-+-+-+-+-+-+-+-+-+-+-+-+-+-+-+-+-+-+
