+-+-+-+-+-+-+-+-+-+-+-+-+-+-+-+-+-+-+-+-+-+-+-+-+-+
 #########|#####|#|#######|       |         |     |
+#+-+-+-+#+#+#+#+#+#+-+-+#+ +-+-+ + + +-+-+ + +-+ +
|#####| |#|#|#|#|###|#####|     | | | |   | |   | |
+-+-+#+ +#+#+-+#+-+-+#+-+-+-+-+ +-+ + + +-+ +-+ + +
|#####| |#|#|###|#####|#######|   | | |   |   | | |
+#+-+-+ +#+#+#+-+#+-+-+#+-+#+-+-+ + + + + +-+ + + +
|###|    #|#|###|#|###|###|###|#|   |   | |   | | |
+-+#+ +-+#+#+#+-+#+#+#+-+#+-+#+#+-+-+-+-+ + +-+-+ +
|###| |###|#|#####|#|#####|#|#|###|       |   |   |
+#+-+-+#+-+#+-+-+-+#+-+-+-+#+#+-+#+ +-+-+ +-+ + +-+
|#|   |###|###|###|#|###|###|#|###|     | |   | | |
+#+ + +-+#+-+#+-+#+#+#+#+#+#+#+#+-+-+-+ + +-+-+ + +
|#| |   |#####|###|###|#|#|#|#|#|   |   |       | |
+#+-+-+ +-+-+#+#+-+-+-+#+#+-+#+#+-+ + +-+-+ +-+-+ +
|###| | |   |###|###|###|###|#|###|   |###| |   | |
+-+#+ + + + +-+#+#+#+-+-+#+#+#+#+#+-+-+#+#+ + + + +
|  ###|   |   |###|#|###|#|#|#|#|###|###|#| | | | |
+-+-+#+ +-+-+ +-+-+#+#+#+#+#+#+#+-+#+#+-+-+ + + + +
|#####| |   |   | |###|###|#####|###|###|     |   |
+#+-+-+ + + +-+ + +-+-+-+-+-+-+-+#+-+#+#+ +-+-+-+-+
|#|###| | | |   |         |     |#####|#|   |     |
+#+#+#+ + + + + + +-+-+-+ + +-+ +-+-+-+#+-+ + +-+ +
|###|#| | |   | | |   | | | |   |   |###|   | |   |
+ +-+-+ + +-+-+-+ + + + + + + +-+ + +#+-+ +-+-+ +-+
| |     |   |     | |     | | |   | |#|   |   |   |
+ + +-+-+-+ + +-+-+ +-+-+-+-+ + +-+ +#+ +-+-+ + + +
|   |   |     |   |     |     | |   |#| |   | | | |
+-+-+ + + +-+-+-+ +-+ + + +-+-+ + +-+-+ + + + + + +
|     | |   |   | |   |   |     |   |   | | | | | |
+ +-+-+ +-+ + + + + +-+-+-+ +-+-+-+ + + + + + + +-+
|     | |   | |   |         |       | | | |   |   |
+-+ + +-+ +-+ +-+-+-+ +-+ +-+ +-+-+-+ +-+ +-+-+-+ +
|   |       |   |     |   |   |   |     |         |
+ +-+-+-+-+ +-+ + +-+-+ +-+ + + + + + + + +-+-+-+-+
| |       | |   |     |   | | | |   | | | |   |   |
+ + + +-+ +-+ +-+-+-+ +-+ + +-+ +-+-+ + + + +-+ + +
| | |   | |   |     | |   |     |     |   |     | |
+ + +-+-+ + +-+ + +-+ +-+-+-+-+-+ + +-+-+-+ +-+-+-+
|   |     |     |   |   |     |   | |             |
+-+-+ +-+-+ +-+-+-+ + + + +-+ + +-+-+ +-+-+-+-+-+ +
|   | |   | |   | | | | | |   | |   |           | |
+ +-+ + + + + + + + +-+ + + +-+ + + +-+-+-+-+-+-+ +
| |   | | |   | | |       | | |   |       |   |   |
+ + +-+-+ +-+-+ + +-+-+ +-+ + +-+-+-+ +-+-+ + + +-+
|   |     | |   | | |     | |   |   |     | | | | |
+ +-+ +-+-+ + +-+ + + +-+-+ +-+ + + +-+-+ + + + + +
| |   |   | | | | | |   |       | | |   |   |   | |
+ + +-+ + + + + + + +-+ + +-+-+-+ + + + +-+-+-+-+ +
|   |   |       |       |         |   |            
+-+-+-+-+-+-+-+-+-+-+-+-+-+-+-+-+-+-+-+-+-+-+-+-+-+
